11111111
100000C1
1EP00001
11111111